########################################
#                                      #
#                                      #
#                                      #
#                                      #
#     ####                             #
#                                      #
#                                      #
#                                      #
#                                      #
#                                      #
#                                      #
#                          ####        #
#                                      #
#                                      #
#                          G           #
#                                      #
#                                      #
#                                      #
########################################