#######################################
#                                    ##
#                                    ##
#                                    ##
#                                    ##
#     ####                           ##
#                                    ##
#                                    ##
#                                    ##
#                                    ##
#                                    ##
#                                    ##
#                          ####      ##
#                                     #
#                                     #
#                          G          #
#                                     #
#                                     #
#                                     #
#######################################