##################################################################################
#                 ##      ##          ##      ##                         ##      #
#   ###############  ##  ######  ##  ######  ##  ##  ##################  ##  ##  #
#           ##  ##  ##          ##          ##                      ##  ##  ##   #
#  #######  ##  ##  ######  ##########################################  ##  ##   #
#       ##  ##  ##      ##          ##              ##                  ##       #
######  ##  ##  ######  ##########  ##  ##########  ##  ######################   #
#       ##          ##  ##  ##      ##      ##      ##      ##      ##           #
##  ##########  ######  ##  ##  ##########  ##  ##########  ##  ##  ##############
#       ##      ##      ##          ##      ##          ##      ##      ##       #
######  ##  ######  ##############  ##############  ##################  ##  ##   #
#       ##      ##              ##  ##              ##              ##      ##   #
#   ##########  ##############  ##  ##  ######  ######  ##########  ######  ##   #
#       ##          ##      ##  ##      ##      ##      ##      ##      ##  ##   #
#   ##  ##########  ######  ##  ##########  ######  ######  ##########  ######   #
#   ##      ##      ##      ##  ##      ##  ##      ##      ##              ##   #
#   ######  ##  ######  ##  ##  ##  ##  ######  ######  ##  ##  ##########  ##   #
#   ##  ##  ##      ##  ##  ##      ##      ##      ##  ##      ##      ##  ##   #
#   ##  ##  ######  ##  ##  ##############  ######  ##############  ##  ##  ##   #
#   ##  ##      ##  ##  ##              ##      ##                  ##  ##  ##   #
#   ##  ######  ##  ##  ######################  ##############  ######  ##  ##   #
#           ##  ##  ##          ##          ##              ##      ##  ##       #
######  ######  ##  ##########  ##  ######  ##############  ######  ##  ##########
#   ##  ##      ##      ##      ##  ##      ##              ##      ##  ##       #
#   ##  ##  ##########  ##  ##  ##  ##  ######  ######################  ##  ##   #
#   ##  ##          ##      ##  ##  ##      ##  ##      ##          ##      ##   #
#   ##  ##########  ##############  ######  ##  ##  ##  ######  ##  ##########   #
#       ##      ##  ##          ##  ##  ##  ##      ##          ##               #
#   ##########  ##  ##  ######  ##  ##  ##  ###################################  #
#               ##          ##          ##                                      G#
##################################################################################